1111111111111111111111111111
1222222222000300000202000021
1211111111110000011111111101
1211111111111121111111111121
1222000002222222200000002001
1211111111111111111111111121
1211111111111111111111111121
1222222220000022222000002221
1211111111111121111111111121
1211111111111121111111111121
1222222200000000000002222221
1211111111111111111111111121
1200000000000000000000000021
1200000000000030000000000021
1211111111111121111111111121
1211111111111121111111111121
1200000000000030000000000021
1211111111111101111111111121
1211111111111111111111111121
1222222222220000002222222221
1211111111111121111111111121
1211111111111121111111111121
1222222220000022222220022221
1211111111111111111111111121
1011111111111111111111111121
1022222220000000000022222221
1011111111111121111111111121
1211111111111121111111111121
12222222220000000000002222P1
1111111111111111111111111111
1111111111111111111111111111

