1111111111111111111111111111
1222222222222222222222222221
1211111111112112111111111121
1211111221122222211221111121
1222221122221111222211222221
1211122221111111111222211121
1211112122222222222212111121
1211112111111111111112111121
1211112211111111111122111121
1211111211102222011121111121
1211111211101111011121111101
1211111211100000011121111101
1211111211100000011121111101
1211111211130000311121111101
1200000000001111000000000001
1211211111132222311111121101
1211222111111111111112221101
1211112111111111111112111101
1211112111111111111112111101
1211112222222222222222111101
1211112111111111111112111101
1211112221111111111222111101
1211111122211111122211111101
1211111111222222221111111121
1211111111112112111111111121
1211111111112112111111111121
1211111111112112111111111121
1211111111112112111111111121
1211111111112112111111111121
1222222222222P22222222222221
1111111111111111111111111111

