1111111111111111111111111111
1P22222220022030022222222221
1211111111112112111111111121
1211111111112112111111111121
1222222111112112111112222221
1211112111112222111112111121
1211112111111111111112111121
1211112222221111222222111121
1211111111121111211111111121
1211111111121111211111111121
1211111111122112211111111121
1211111111110000111111111121
1211111111100110011111111121
1211111111001111001111111121
1211111110011301100111111121
1211111110000220000111111121
1211111110011331100111111121
1211111111001111001111111121
1211111111122112211111111121
1211111111110000111111111121
1211111111122112211111111121
1211111111121111211111111121
1211111111121111211111111121
1211112222221111222222111121
1211112111111111111112111121
1211112111112222111112111121
1222222111112112111112222221
1211111111112112111111111121
1211111111112112111111111121
1222222222222222222222222221
1111111111111111111111111111

