1111111111111111111111111111
12222222222222222222222222P1
1211111111111111111111111121
1211111111111111111111111121
1211111111111111111111111121
1211122222222222222222222221
1211121111111111111111111121
1211121111111111111111111121
1211121111111111111111111121
1211122222222222222222211121
1211121112111111111111211121
1211121112111111111111211121
1211121110111111111111211121
1211121110111000000111211121
1211121110111311110111211121
1211121110000330000111211121
1211121112111131110111211121
1211121110000001110111211121
1211121111111111110111211121
1211121111111111110111211121
1211121111111111110111211121
1211122222222222222222211121
1211111111111111111111211121
1211111111111111111111211121
1211111111111111111111211121
1222222222222222222222211121
1211111111111111111111111121
1211111111111111111111111121
1211111111111111111111111121
1222222222222222222222222221
1111111111111111111111111111

